####################
#S.....#...........#
#.###...#######.##.#
#.#.#.#.....#.....##
#.#...##.##.###.#..#
#...#.#...#...#.##.#
###.#.#.#.#.#.#.#..#
#.#.#.#.#.#.#.#.##.#
#.#.#.#.#.#.#.#....#
#.#.#.#...#.#.######
#...#.#.#.#.#......#
#.#.#.#...#.######.#
#.#.#.#.#........#.#
#.#.#.#.#.######.#.#
#.#.#.#.#......#...#
#.#.#.#.#.####.#.#.#
#.#.#.#......#.#.#.#
#.#.#.#.####.#.#.#.#
#.#..........#...#G#
####################