###############
#S....#.#.....#
#.###.#.#.###.#
#.#...#.#.#.#.#
#.#.###.#.#.#.#
#.#.#.....#.#.#
#.#.#.#####.#.#
#...#.#...#.#.#
###.#.###.#.#.#
#...#.....#.#.#
#.###.#####.#.#
#.....#.....#.#
#.#####.###.#.#
#.....#...#..G#
###############