###############
#S..#.....#...#
#.###.###.#.#.#
#.#...#...#.#.#
#.#.###.###.#.#
#.#.#.....#.#.#
#.#.#.###.#.#.#
#...#.#.#.#...#
###.#.#.#.###.#
#...#.#.#.....#
#.###.#.#####.#
#.....#.....#.#
#.#####.###.#.#
#.......#...G.#
###############