###############
#.....#...#..G#
#.###.#.#.###.#
#.#...#.#.....#
#.#.###.#####.#
#.#.#.....#.#.#
#.#.#.###.#.#.#
#...#.#.#.#.#.#
###.#.#.#.###.#
#...#.#.#.....#
#.###.#.#####.#
#.....#.....#.#
#.#####.###.#.#
#S......#.....#
###############