####################
#S.....#......#....#
#.###.#.#######.##.#
#.#.#.#.....#.....##
#.#.#.#####.###.#..#
#...#.#...#...#.##.#
###.#.#.#.#.#.#.#..#
#.#.#.#.#.#.#.#.##.#
#.#.#.#.#.#.#.#....#
#.#.#.#.#.#.#.######
#...#.#.#.#.#......#
#.#.#.#...#.######.#
#.#.#.#.#.#......#.#
#.#.#.#.#.######.#.#
#.#.#.#.#......#.#.#
#.#.#.#.#.####.#.#.#
#.#.#.#......#.#.#.#
#.#.#.#.####.#.#.#.#
#.#.#........#...#G#
####################