#######
#S..#.#
#.#..##
#.#.#G#
#.....#
#######